E P E E E E E E E E
E P P P P P P P E E
E E E E E E E P E E
E E E E E E E P E E
E E E E E E E P E E
E E E E P P P P E E
E E E P P E E E E E
P P P P E E E E E E
E E E E E E E E E E
E E E E E E E E E E
